+-+-+-+-+-+-+-+-+-+-+-+-+-+-+-+-+
|             |   |             |
+ +-+-+-+ +-+ + + + +-+ +-+ + + +
|       |   |   |   |   |   | | |
+ +-+-+-+-+ +-+ + +-+ +-+ +-+ + +
| |       |   |   |   |       | |
+ + + +-+ +-+ +-+-+ +-+ +-+-+ + +
|   |       |   |   |         | |
+-+-+-+-+-+ +-+ + +-+ + +-+ +-+ +
|             |   |   | |   |   |
+ +-+-+-+-+-+-+-+-+ +-+ + +-+ + +
|             |           |   | |
+ + +-+-+-+-+ +-+-+ +-+ +-+ +-+ +
| | |       | |         |   |   |
+ + + +-+-+ + +-+-+ + +-+ +-+ +-+
| | | |   | | |     | |   |     |
+ + + +-+ + + + + + + + +-+ +-+ +
|   |     | | |   | | |   |     |
+-+ +-+-+-+ + +-+-+-+-+-+ +-+ +-+
|           |         | |   |   |
+-+ +-+-+-+-+-+-+-+-+ + +-+ +-+ +
|         | |       | |   |     |
+ + +-+-+ +-+ +-+-+ + + + +-+ +-+
| |         | |   | | | |   |   |
+ + +-+-+ + + + + + + + + + +-+ +
| |     | | | | | | | | | |   | |
+ + +-+ + + + + +-+ + + + +-+ + +
|   | | | | | |     | | |   |   |
+ + +-+ + + + +-+-+-+ + + + + + +
| | |                 |   |   | |
+ + +-+-+ + + +-+-+-+ + + +-+ + +
| |       | |           |       |
+-+-+-+-+-+-+-+-+-+-+-+-+-+-+-+-+
