+-+-+-+-+-+-+-+-+-+-+-+-+-+-+-+-+
|                               |
+ +-+-+-+-+-+-+-+-+-+-+-+-+-+-+ +
|             |                 |
+-+ +-+-+-+-+ + +-+-+-+-+-+-+-+-+
|     |       |       |         |
+-+ +-+ +-+-+-+-+-+-+ + + +-+-+ +
|     | |       |     | |     | |
+-+ +-+ + +-+ +-+ +-+-+ +-+ +-+ +
|     | |   |   |   |   |   |   |
+-+ +-+ +-+ +-+ +-+ + +-+ + + +-+
|     |   |   | |     |   | |   |
+-+ +-+-+ +-+ + + +-+-+ + + +-+ +
|     |     | |   | |   |   |   |
+-+ +-+-+-+ + +-+-+ + + + +-+ +-+
|   |     | | |   |   | | |     |
+ + + +-+ + + + + + +-+ + + +-+ +
| | |   | |   |           |     |
+ + +-+ + +-+-+-+-+-+-+-+-+-+ +-+
|       | |     |     |   |     |
+ + +-+-+ + +-+ + +-+ + + +-+-+ +
| |   |   | |   | | | | |     | |
+ + + + + + + +-+ + + + +-+-+ + +
|   |   | | |   |   | |   |   | |
+ + + +-+ + +-+ +-+-+ +-+ + +-+ +
| |         |     |       |     |
+ + +-+-+ +-+ +-+ +-+ +-+-+-+-+ +
|   |     |   |       |   |     |
+ +-+ +-+-+ +-+ +-+ +-+ + + +-+-+
|   |   |   |     |     |       |
+ + + + + + +-+-+ + +-+-+-+-+-+ +
| |   |   |       |             |
+-+-+-+-+-+-+-+-+-+-+-+-+-+-+-+-+
