+-+-+-+-+-+-+-+-+-+-+-+-+-+-+-+-+
|   |             |           | |
+-+ +-+-+ +-+-+ + +-+ +-+-+-+ + +
| |   |   |   | |   |   |   | | |
+ +-+ + +-+ + + +-+-+ +-+ + + + +
| |     |   | |   | | | |   |   |
+ +-+-+ + +-+ + +-+ + + + + + +-+
|   |     |   |       | |   |   |
+ +-+-+ +-+-+-+ +-+-+-+ +-+-+ +-+
|               |               |
+ +-+-+ +-+ +-+-+-+-+ +-+-+-+-+-+
| |     |       | |   | | |   | |
+ + +-+-+-+-+ + + + +-+ + +-+ + +
| |       | | | |   |         | |
+ + +-+-+ +-+ +-+ + + +-+ +-+-+ +
| |     |     |   | |   |       |
+ + +-+ +-+-+-+ + + +-+ + +-+-+-+
| | |         |   | |     |     |
+-+ +-+-+ +-+ + +-+-+ + +-+ +-+ +
|         |   |     | | |   |   |
+ +-+ + +-+-+-+ +-+ + + + +-+-+ +
| |   | |         |   |   | |   |
+ + +-+ + +-+-+-+ + +-+ +-+ +-+ +
|   |   |   |   | | |   |   |   |
+ +-+ + +-+ + + +-+-+ +-+ +-+-+ +
|     | |   | |     |           |
+ +-+-+ + +-+ + +-+-+-+ +-+ +-+ +
|   |   | |   |   | | |   |   | |
+ + + +-+ + + + + + + +-+ +-+ + +
| | |   | | | | |   |   |   | | |
+ + + + +-+-+ + + +-+ +-+-+ +-+-+
| |   |                         |
+-+-+-+-+-+-+-+-+-+-+-+-+-+-+-+-+
