+-+-+-+-+-+-+-+-+-+-+-+-+-+-+-+-+
| |   |                         |
+ + + + +-+-+-+-+-+-+-+-+-+-+-+ +
| | |   |                       |
+ + + + + +-+-+-+-+-+-+-+-+-+-+ +
|     | | |       |           | |
+-+ + + + +-+-+-+ + +-+-+-+-+ + +
|   | | | |         |         | |
+ +-+ + + + +-+-+ +-+ +-+-+-+ + +
|     | | |         |       | | |
+ +-+-+ + + +-+ +-+ +-+-+-+ + + +
|       | | |     | |       | | |
+ +-+-+-+ + + +-+-+-+ +-+-+-+ + +
| |       |     |   |       | | |
+ + +-+-+-+ + +-+ + +-+-+-+ + + +
| |         | |   |         | | |
+ + +-+-+-+-+-+ + + +-+-+-+-+-+-+
| | |       | |   |             |
+ + + +-+-+ + +-+-+ + +-+ +-+ + +
| |       | |       |         | |
+ +-+-+-+ + + +-+-+-+-+ + +-+ + +
|       | | |           |     | |
+ +-+-+ + + +-+-+-+-+-+-+-+-+ + +
|     | | | |                   |
+ +-+ + + + + +-+-+-+-+-+-+-+-+ +
|   | | | | |                 | |
+-+ + + + + +-+-+-+-+-+-+-+-+ + +
|     | | |                   | |
+ + + + + +-+-+-+-+-+-+-+-+-+-+-+
| | |   |                       |
+ + + + +-+-+-+-+-+-+-+-+-+-+-+ +
| | | |                         |
+-+-+-+-+-+-+-+-+-+-+-+-+-+-+-+-+
