+-+-+-+-+-+-+-+-+-+-+-+-+-+-+-+-+
| |     |                     | |
+-+-+ +-+-+-+ +-+-+-+ + +-+ +-+ +
|   | |       |       | | | | | |
+-+ + + +-+-+ + +-+-+-+ + + + + +
| |     |       |       | |   | |
+ + +-+ +-+-+-+ + +-+-+ + + + + +
| | |             |         |   |
+ + + +-+-+ +-+-+-+-+-+ +-+ + + +
| | |   | | |           |   | | |
+ + + + + + +-+-+-+ +-+-+ +-+ + +
|   | |     |     |         | | |
+ + + +-+-+ + +-+ +-+-+-+ + +-+ +
| |   | |   | |         | | | | |
+ +-+-+ + + +-+-+-+ +-+-+ + + +-+
|   |     | | |   | |     |   | |
+-+-+ + +-+-+ + + + +-+-+ + + + +
|     |       |         |   |   |
+ +-+-+-+-+ +-+-+-+ +-+ +-+ + + +
| |     |   |   |           | | |
+ + + + +-+-+ + +-+-+-+ + + + + +
| |     |     |     |   | | | | |
+ + + + + +-+ + +-+ +-+-+-+ + + +
| |     |   | | |       | | | | |
+ + + + + +-+-+ + +-+-+ + +-+ + +
| |     |     | |         | | | |
+ +-+ + +-+-+ + +-+-+-+-+ + + + +
|   |   |     |   |     |     | |
+ + +-+-+ +-+-+ +-+-+-+ + +-+ + +
| |   |   |   | |         |     |
+ + +-+ +-+-+ + + +-+-+-+-+-+-+-+
| |                             |
+-+-+-+-+-+-+-+-+-+-+-+-+-+-+-+-+
