+-+-+-+-+-+-+-+-+-+-+-+-+-+-+-+-+
|                               |
+ +-+-+-+-+-+-+-+-+-+-+-+-+-+-+ +
| |   |   |                     |
+ + + + + + +-+-+-+-+-+-+ +-+ + +
|   |   |   |         |   |   | |
+-+ +-+-+-+-+ +-+-+-+ + +-+ +-+ +
|     | | | |   |   |   |   | | |
+-+-+ + + + +-+ + + + +-+ +-+ + +
|   | |       | | | | |   |   | |
+ + + + + + + + + + + + +-+ + + +
| | | | | | |   | | | | |   | | |
+ + + + +-+-+-+-+ + + + + +-+ + +
| |   | |         |   |   |   | |
+ +-+-+ + +-+-+-+-+-+-+-+-+ +-+ +
|     | | |   |   | | | |   |   |
+-+ + + + + + + + + + + + +-+ + +
|   | | |   | |         | |   | |
+ +-+ + +-+ + +-+-+ +-+ + + +-+ +
|   | |   | |   | |   | | |   | |
+-+ + +-+ +-+ +-+ +-+ + + +-+ + +
|   |   |           | | | |   | |
+ +-+-+ + + +-+-+ + + + + + +-+ +
|   | | | |     | | | |   |   | |
+-+ + + +-+-+-+ +-+ + + +-+-+ + +
|   |   | | | |   | | |       | |
+ +-+ +-+ + + +-+ + + +-+-+-+-+ +
| |   |         | | |         | |
+ + + + + + + + + + +-+-+-+-+ + +
|   |   | | | |   | |         | |
+ + + + + + + +-+ + + +-+-+-+-+ +
| |   |             |           |
+-+-+-+-+-+-+-+-+-+-+-+-+-+-+-+-+
