+-+-+-+-+-+-+-+-+-+-+-+-+-+-+-+-+
| |                     |   |   |
+ + + +-+-+-+ +-+-+-+-+ + + + + +
| | | |   |   |         | | | | |
+ + + + + + +-+ +-+-+-+-+ + + + +
| |   | |     |         | |   | |
+ +-+-+ +-+-+-+-+-+-+-+ + +-+-+ +
|       | |             |     | |
+ +-+-+-+ + +-+-+-+-+-+ +-+-+ + +
| |       | |       |   |     | |
+ + +-+ +-+ + + +-+ + +-+ +-+ + +
|   |   | | | |   | | | | |   | |
+ +-+ +-+ + + + + + +-+-+ + +-+ +
| |       | |   | | |   |     | |
+ + +-+-+ + + + +-+ + +-+ +-+ + +
|   |     | | |   | | |       | |
+ +-+ +-+ + + + + + + + +-+ +-+ +
|       | | | |   | |   |     | |
+ + +-+ + + + + +-+ + +-+ +-+-+ +
| |   |   | | |   |   |     |   |
+ +-+ +-+ + + + + +-+-+ +-+-+ + +
|         |   | | |     |     | |
+-+-+-+-+ + + + + + +-+ +-+ + + +
|         | | |   |     |   | | |
+ +-+-+-+ + + + + + +-+-+ +-+ + +
|     |   |     | | |   | |   | |
+-+-+ +-+ +-+-+ +-+ + + + + +-+ +
|   |   |     |     | | | |     |
+ + + + + +-+ +-+-+-+ + + + +-+-+
| | | | | |           |   |     |
+ + + + + +-+-+-+-+-+-+-+-+-+-+ +
| |   |                         |
+-+-+-+-+-+-+-+-+-+-+-+-+-+-+-+-+
