+-+-+-+-+-+-+-+-+-+-+-+-+-+-+-+-+
|                               |
+ +-+-+-+ +-+-+-+-+-+-+-+-+-+-+-+
| |       |                   | |
+ + + +-+-+-+ +-+-+-+-+-+ +-+-+ +
|   | |   |   |   |           | |
+ +-+ + +-+ +-+ + +-+ + +-+ +-+ +
|   | | |   |   |     |   |     |
+ +-+ + + +-+ + + + +-+-+ + +-+ +
| | | |   |   | | |             |
+-+ + + +-+-+ +-+-+ + +-+-+-+-+ +
| | |       |     | | |       | |
+ + +-+-+ +-+ +-+-+-+ +-+-+-+-+ +
|           |       |           |
+-+ +-+-+-+ + +-+-+ + + + +-+-+-+
| | |     | | |   | | | |       |
+ + + + + + + + + + + + +-+-+-+ +
|   |     | | |   | | |       | |
+ +-+ + + + + +-+ + + +-+ +-+-+ +
| | |     | | |     | | |   |   |
+ + +-+-+-+ + + +-+ + + + + + +-+
|           | | |   | |   | |   |
+ + + + + +-+ +-+-+-+ + +-+ +-+ +
| | | | | |     | |   |   | |   |
+ + + + +-+-+-+-+ + +-+ +-+ + +-+
| | | |         |               |
+ + + +-+-+-+-+ +-+-+-+-+-+-+ + +
|   |   | |                 | | |
+ + + +-+ + +-+-+-+ +-+-+ + + + +
| |                 |     | |   |
+ + +-+-+-+-+-+-+-+-+-+-+-+ +-+ +
| |                             |
+-+-+-+-+-+-+-+-+-+-+-+-+-+-+-+-+
