+-+-+-+-+-+-+-+-+-+-+-+-+-+-+-+-+
|   |                       |   |
+ +-+ +-+-+-+-+-+-+-+-+-+ + + + +
|     |                 | | | | |
+ +-+-+ + +-+-+-+-+-+-+ +-+ + + +
|   |   | |         |     |   | |
+ +-+ +-+ + +-+ +-+ +-+-+ +-+-+ +
| |       | |     | |   |     | |
+ +-+ +-+-+ +-+ +-+ + + + +-+ + +
| |     |   |     |   | | |   | |
+ +-+ +-+ +-+-+ +-+-+-+ + +-+ + +
| |     |   |     |   | |   | | |
+ + +-+ +-+ +-+ +-+ + + +-+ + + +
| |       | |       | |   | | | |
+ + +-+-+ + +-+ +-+-+ +-+ + + + +
| |     | |   |   |   | | | | | |
+ +-+-+ + +-+ + + + +-+ + + + + +
| |     | |   |   |   |   | | | |
+ + +-+-+ + +-+-+-+-+ +-+ + + + +
| |     |     |   |   |   | | | |
+ +-+-+ +-+-+ + + + +-+ +-+ + + +
| |     |   |   |   | | |   | | |
+ + +-+-+ + +-+-+-+-+ + +-+ + + +
| |       | |       |   |   | | |
+ + +-+-+-+ + + +-+ +-+ + +-+ + +
| |   |   |   |     |   | | | | |
+ + + + + +-+-+-+-+ + +-+ + + + +
| | |   |     |   |     | |   | |
+ + +-+-+ + +-+ + +-+-+ + + +-+ +
| | | | | |     |         | |   |
+ + + + +-+-+-+-+-+-+-+-+-+ +-+ +
| |                             |
+-+-+-+-+-+-+-+-+-+-+-+-+-+-+-+-+
