+-+-+-+-+-+-+-+-+-+-+-+-+-+-+-+-+
|                               |
+ +-+-+-+-+-+-+-+-+-+-+-+-+-+-+ +
| |                             |
+ + +-+-+-+-+-+-+-+-+ +-+-+-+-+ +
| | |             |           | |
+ + + +-+-+-+ +-+-+-+-+ +-+-+ + +
| | | | |   |     | |   |     | |
+ + + + + + +-+-+ + + +-+ +-+-+ +
| | | |   | |   |   | |       | |
+ + + + +-+ + + +-+ + +-+-+-+ + +
| | | |   | | |   |   |       | |
+ + + +-+ + + +-+ +-+-+ +-+-+-+ +
| | |     | | |       |     | | |
+ + +-+-+-+ + +-+-+-+ +-+-+ + + +
| | |   |   | |     |       | | |
+ + + + +-+ + + + + +-+-+-+-+ + +
| | | |   | | |   |     |     | |
+ + + +-+ + + +-+-+-+ +-+ + + + +
| | | |   |   |     |   | | | | |
+ + + + +-+ +-+-+ + +-+ + +-+ + +
| | | |     |   | |   |       | |
+ + + +-+-+-+ + + +-+ +-+ +-+ + +
| | |       | | |   |   |   | | |
+ + +-+-+-+ + + +-+ +-+ +-+ + + +
| | |       | | |     |   |   | |
+ + + +-+-+-+ + +-+-+ +-+ +-+ + +
|   | |       | |       |   | | |
+ + + +-+-+-+ + +-+-+-+ +-+ + + +
| | |         |         |     | |
+ + +-+-+-+-+-+-+-+-+-+-+-+-+-+ +
| |                             |
+-+-+-+-+-+-+-+-+-+-+-+-+-+-+-+-+
