+-+-+-+-+-+-+-+-+-+-+-+-+-+-+-+-+
|                               |
+ +-+-+-+-+-+-+-+-+-+-+-+-+-+-+ +
| |                           | |
+ + +-+-+-+-+-+-+-+-+-+-+-+ +-+ +
| | |   |                 |   | |
+ + + + + + +-+-+-+-+ +-+ +-+ + +
| | | | | |           | |   |   |
+ + + + + +-+ +-+-+ +-+ +-+ +-+ +
| | | | |   |   |   |     |   | |
+ + + + + +-+-+ + +-+ + +-+ +-+ +
| | | | |     |   |   |     | | |
+ + + + + +-+-+ + +-+ +-+ +-+ +-+
| | | | |   |   |   |   | |     |
+ + + + + +-+ +-+-+ +-+ +-+-+ +-+
| | | |   |   |   |   |   |     |
+ + + + +-+ +-+ + +-+ +-+ + +-+ +
| | | | |   |       |   |   |   |
+ + + +-+ +-+ +-+-+ +-+ +-+-+ +-+
| |   |   | |   |   | |   |     |
+ + +-+ +-+ +-+ + +-+ +-+ +-+ +-+
| | |   |     |   |     |   |   |
+ +-+ +-+ + +-+ + +-+ + +-+ +-+ +
| |   |   |     |     |   |   | |
+ +-+ + +-+-+ +-+-+ +-+-+ + +-+ +
| |     | |     |     | |   |   |
+ +-+ + + + +-+ + +-+ + + +-+ +-+
|   | |     | |   | |     |     |
+-+ + +-+ +-+ +-+-+ +-+ +-+-+ +-+
|   |     |     |     | |   |   |
+ + +-+-+-+ +-+ + +-+ +-+ + +-+ +
| |         |       |     |     |
+-+-+-+-+-+-+-+-+-+-+-+-+-+-+-+-+
