+-+-+-+-+-+-+-+-+-+-+-+-+-+-+-+-+
|                               |
+ +-+-+-+-+-+-+-+-+-+-+-+-+-+-+ +
| |                             |
+ + +-+-+-+-+-+-+-+-+-+-+-+-+ + +
| |       |   |       |     | | |
+ + +-+-+ + + + +-+-+ + +-+ + + +
| | |     | |   |   | |   | | | |
+ + + + +-+ +-+-+ + + +-+ + + + +
| | | | |   | |   | | |   | | | |
+ + + +-+ +-+ + +-+ + + +-+ + + +
| | | |   | |     | | |   | | | |
+ + + + +-+ + +-+ + + +-+ + + + +
| | | | | |       |   |   | | | |
+ + + + + + +-+-+-+-+-+-+ + + + +
| | |   |     |   |       | | | |
+ + +-+-+ +-+ + + + +-+ + + + + +
| | |         |   |     | | | | |
+ + + +-+-+-+-+-+ +-+ + +-+ + + +
| | |   |         |   | |   | | |
+ + +-+ + +-+ +-+-+ + +-+ +-+ + +
| | |   |   | |     | |   | | | |
+ + + +-+ + +-+-+ + +-+ +-+ + + +
| | |   | | | |   | |   |   | | |
+ + +-+ + +-+ + +-+-+ +-+ + + + +
| |   |   |   |   |   |   | | | |
+ +-+ + +-+ + +-+ + +-+ +-+ + + +
|   | |     |     |     |   | | |
+ + + +-+-+-+-+-+-+-+-+-+-+ + + +
| | |                         | |
+ + +-+-+-+-+-+-+-+-+-+-+-+-+-+ +
| |                             |
+-+-+-+-+-+-+-+-+-+-+-+-+-+-+-+-+
