+-+-+-+-+-+-+-+-+-+-+-+-+-+-+-+-+
|   |                           |
+ + + +-+-+-+-+-+ + +-+-+-+-+ + +
| | |   |       | |         | | |
+ + +-+ + +-+-+-+ + +-+-+-+ + + +
| |     |         | |       | | |
+ +-+ +-+-+-+-+-+-+ +-+-+-+ + + +
| |   |                     | | |
+ + + + +-+ +-+-+-+-+-+-+-+-+ + +
| | |     |               |   | |
+ + +-+ + + +-+-+-+-+-+ + + + + +
| |   | | |           | | | | | |
+ +-+ + + + +-+ +-+-+ + + +-+ + +
|     | | | |   |   |   |     | |
+ + +-+ + + + +-+ + +-+ + +-+-+ +
| |   | | | | |   |   | |   |   |
+ +-+ + + + + + + +-+ + +-+ + + +
| |   | | | | |   |   |   | | | |
+ + + + + + + +-+-+ +-+-+ + + + +
| | | |   | |     |   |   | | | |
+ + + +-+-+ +-+-+ +-+ + +-+ + + +
| | | |         |   |   |   | | |
+ + + +-+-+-+-+ +-+ + +-+ + + + +
| | |     |   |   |   |   | | | |
+ + + +-+ + + +-+ +-+ + +-+ + + +
|   |   | | |   |           | | |
+-+ +-+-+ + +-+ +-+ +-+-+-+-+ + +
|   |     |   |   |           | |
+ + +-+-+ +-+ +-+ +-+-+-+-+-+ + +
| |       | |   |             | |
+ + +-+-+-+ +-+ +-+-+-+-+-+-+-+ +
|||                             |
+-+-+-+-+-+-+-+-+-+-+-+-+-+-+-+-+
